"filename", "language", "C", "C++", "comment", "blank", "total"
"d:\MyProject-Temp\Project.HoitOS\HoitOS\SylixOS\Workspace\SylixBSP\SylixOS\extfs\hoitFs\hoitFs.c", "C", 1082, 0, 344, 252, 1678
"d:\MyProject-Temp\Project.HoitOS\HoitOS\SylixOS\Workspace\SylixBSP\SylixOS\extfs\hoitFs\hoitFs.h", "C++", 0, 14, 30, 5, 49
"d:\MyProject-Temp\Project.HoitOS\HoitOS\SylixOS\Workspace\SylixBSP\SylixOS\extfs\hoitFs\hoitFsCache.c", "C", 468, 0, 225, 68, 761
"d:\MyProject-Temp\Project.HoitOS\HoitOS\SylixOS\Workspace\SylixBSP\SylixOS\extfs\hoitFs\hoitFsCache.h", "C++", 0, 88, 45, 18, 151
"d:\MyProject-Temp\Project.HoitOS\HoitOS\SylixOS\Workspace\SylixBSP\SylixOS\extfs\hoitFs\hoitFsCmd.c", "C", 76, 0, 31, 16, 123
"d:\MyProject-Temp\Project.HoitOS\HoitOS\SylixOS\Workspace\SylixBSP\SylixOS\extfs\hoitFs\hoitFsCmd.h", "C++", 0, 6, 20, 3, 29
"d:\MyProject-Temp\Project.HoitOS\HoitOS\SylixOS\Workspace\SylixBSP\SylixOS\extfs\hoitFs\hoitFsFDLib.c", "C", 159, 0, 72, 29, 260
"d:\MyProject-Temp\Project.HoitOS\HoitOS\SylixOS\Workspace\SylixBSP\SylixOS\extfs\hoitFs\hoitFsFDLib.h", "C++", 0, 13, 23, 5, 41
"d:\MyProject-Temp\Project.HoitOS\HoitOS\SylixOS\Workspace\SylixBSP\SylixOS\extfs\hoitFs\hoitFsGC.c", "C", 371, 0, 103, 64, 538
"d:\MyProject-Temp\Project.HoitOS\HoitOS\SylixOS\Workspace\SylixBSP\SylixOS\extfs\hoitFs\hoitFsGC.h", "C++", 0, 39, 31, 13, 83
"d:\MyProject-Temp\Project.HoitOS\HoitOS\SylixOS\Workspace\SylixBSP\SylixOS\extfs\hoitFs\hoitFsLib.c", "C", 1280, 0, 488, 181, 1949
"d:\MyProject-Temp\Project.HoitOS\HoitOS\SylixOS\Workspace\SylixBSP\SylixOS\extfs\hoitFs\hoitFsLib.h", "C++", 0, 61, 27, 14, 102
"d:\MyProject-Temp\Project.HoitOS\HoitOS\SylixOS\Workspace\SylixBSP\SylixOS\extfs\hoitFs\hoitFsLog.c", "C", 359, 0, 127, 82, 568
"d:\MyProject-Temp\Project.HoitOS\HoitOS\SylixOS\Workspace\SylixBSP\SylixOS\extfs\hoitFs\hoitFsLog.h", "C++", 0, 12, 23, 8, 43
"d:\MyProject-Temp\Project.HoitOS\HoitOS\SylixOS\Workspace\SylixBSP\SylixOS\extfs\hoitFs\hoitFsMid.c", "C", 3, 0, 20, 6, 29
"d:\MyProject-Temp\Project.HoitOS\HoitOS\SylixOS\Workspace\SylixBSP\SylixOS\extfs\hoitFs\hoitFsMid.h", "C++", 0, 3, 20, 5, 28
"d:\MyProject-Temp\Project.HoitOS\HoitOS\SylixOS\Workspace\SylixBSP\SylixOS\extfs\hoitFs\hoitFsTest.c", "C", 700, 0, 156, 84, 940
"d:\MyProject-Temp\Project.HoitOS\HoitOS\SylixOS\Workspace\SylixBSP\SylixOS\extfs\hoitFs\hoitFsTest.h", "C++", 0, 5, 20, 2, 27
"d:\MyProject-Temp\Project.HoitOS\HoitOS\SylixOS\Workspace\SylixBSP\SylixOS\extfs\hoitFs\hoitFsTree.c", "C", 452, 0, 233, 81, 766
"d:\MyProject-Temp\Project.HoitOS\HoitOS\SylixOS\Workspace\SylixBSP\SylixOS\extfs\hoitFs\hoitFsTree.h", "C++", 0, 108, 54, 27, 189
"d:\MyProject-Temp\Project.HoitOS\HoitOS\SylixOS\Workspace\SylixBSP\SylixOS\extfs\hoitFs\hoitFsTreeUtil.c", "C", 337, 0, 183, 56, 576
"d:\MyProject-Temp\Project.HoitOS\HoitOS\SylixOS\Workspace\SylixBSP\SylixOS\extfs\hoitFs\hoitFsTreeUtil.h", "C++", 0, 20, 20, 10, 50
"d:\MyProject-Temp\Project.HoitOS\HoitOS\SylixOS\Workspace\SylixBSP\SylixOS\extfs\hoitFs\hoitType.h", "C++", 0, 290, 111, 70, 471
"d:\MyProject-Temp\Project.HoitOS\HoitOS\SylixOS\Workspace\SylixBSP\SylixOS\extfs\spifFs\spifFs.c", "C", 940, 0, 370, 217, 1527
"d:\MyProject-Temp\Project.HoitOS\HoitOS\SylixOS\Workspace\SylixBSP\SylixOS\extfs\spifFs\spifFs.h", "C++", 0, 38, 23, 11, 72
"d:\MyProject-Temp\Project.HoitOS\HoitOS\SylixOS\Workspace\SylixBSP\SylixOS\extfs\spifFs\spifFsCache.c", "C", 303, 0, 135, 33, 471
"d:\MyProject-Temp\Project.HoitOS\HoitOS\SylixOS\Workspace\SylixBSP\SylixOS\extfs\spifFs\spifFsCache.h", "C++", 0, 25, 32, 7, 64
"d:\MyProject-Temp\Project.HoitOS\HoitOS\SylixOS\Workspace\SylixBSP\SylixOS\extfs\spifFs\spifFsConfig.h", "C++", 0, 103, 122, 10, 235
"d:\MyProject-Temp\Project.HoitOS\HoitOS\SylixOS\Workspace\SylixBSP\SylixOS\extfs\spifFs\spifFsFDLib.c", "C", 165, 0, 76, 8, 249
"d:\MyProject-Temp\Project.HoitOS\HoitOS\SylixOS\Workspace\SylixBSP\SylixOS\extfs\spifFs\spifFsFDLib.h", "C++", 0, 10, 20, 2, 32
"d:\MyProject-Temp\Project.HoitOS\HoitOS\SylixOS\Workspace\SylixBSP\SylixOS\extfs\spifFs\spifFsGC.c", "C", 438, 0, 165, 45, 648
"d:\MyProject-Temp\Project.HoitOS\HoitOS\SylixOS\Workspace\SylixBSP\SylixOS\extfs\spifFs\spifFsGC.h", "C++", 0, 26, 20, 4, 50
"d:\MyProject-Temp\Project.HoitOS\HoitOS\SylixOS\Workspace\SylixBSP\SylixOS\extfs\spifFs\spifFsGlue.c", "C", 232, 0, 133, 31, 396
"d:\MyProject-Temp\Project.HoitOS\HoitOS\SylixOS\Workspace\SylixBSP\SylixOS\extfs\spifFs\spifFsGlue.h", "C++", 0, 15, 23, 4, 42
"d:\MyProject-Temp\Project.HoitOS\HoitOS\SylixOS\Workspace\SylixBSP\SylixOS\extfs\spifFs\spifFsLib.c", "C", 1098, 0, 373, 136, 1607
"d:\MyProject-Temp\Project.HoitOS\HoitOS\SylixOS\Workspace\SylixBSP\SylixOS\extfs\spifFs\spifFsLib.h", "C++", 0, 48, 53, 8, 109
"d:\MyProject-Temp\Project.HoitOS\HoitOS\SylixOS\Workspace\SylixBSP\SylixOS\extfs\spifFs\spifFsType.h", "C++", 0, 335, 208, 41, 584
"d:\MyProject-Temp\Project.HoitOS\HoitOS\SylixOS\Workspace\SylixBSP\SylixOS\extfs\spifFs\spifFsVerify.c", "C", 0, 0, 20, 4, 24
"d:\MyProject-Temp\Project.HoitOS\HoitOS\SylixOS\Workspace\SylixBSP\SylixOS\extfs\tools\hash\hash_template.h", "C++", 0, 13, 6, 2, 21
"d:\MyProject-Temp\Project.HoitOS\HoitOS\SylixOS\Workspace\SylixBSP\SylixOS\extfs\tools\list\common.h", "C++", 0, 47, 6, 13, 66
"d:\MyProject-Temp\Project.HoitOS\HoitOS\SylixOS\Workspace\SylixBSP\SylixOS\extfs\tools\list\iter.c", "C", 28, 0, 6, 9, 43
"d:\MyProject-Temp\Project.HoitOS\HoitOS\SylixOS\Workspace\SylixBSP\SylixOS\extfs\tools\list\list.c", "C", 96, 0, 20, 20, 136
"d:\MyProject-Temp\Project.HoitOS\HoitOS\SylixOS\Workspace\SylixBSP\SylixOS\extfs\tools\list\list_interface.h", "C++", 0, 36, 12, 3, 51
"d:\MyProject-Temp\Project.HoitOS\HoitOS\SylixOS\Workspace\SylixBSP\SylixOS\extfs\tools\list\list_template.h", "C++", 0, 136, 14, 7, 157
"d:\MyProject-Temp\Project.HoitOS\HoitOS\SylixOS\Workspace\SylixBSP\SylixOS\extfs\tools\list\list_test.c", "C", 78, 0, 11, 12, 101
"Total", "-", 8665, 1491, 4254, 1726, 16136