"filename", "language", "C", "C++", "comment", "blank", "total"
"d:\MyProject-Temp\Project.HoitOS\HoitOS\SylixOS\Workspace\SylixBSP\SylixOS\extfs\hoitFs\hoitFs.c", "C", 1082, 0, 343, 252, 1677
"d:\MyProject-Temp\Project.HoitOS\HoitOS\SylixOS\Workspace\SylixBSP\SylixOS\extfs\hoitFs\hoitFs.h", "C++", 0, 14, 30, 5, 49
"d:\MyProject-Temp\Project.HoitOS\HoitOS\SylixOS\Workspace\SylixBSP\SylixOS\extfs\hoitFs\hoitFsCache.c", "C", 468, 0, 225, 68, 761
"d:\MyProject-Temp\Project.HoitOS\HoitOS\SylixOS\Workspace\SylixBSP\SylixOS\extfs\hoitFs\hoitFsCache.h", "C++", 0, 88, 45, 17, 150
"d:\MyProject-Temp\Project.HoitOS\HoitOS\SylixOS\Workspace\SylixBSP\SylixOS\extfs\hoitFs\hoitFsCmd.c", "C", 76, 0, 31, 16, 123
"d:\MyProject-Temp\Project.HoitOS\HoitOS\SylixOS\Workspace\SylixBSP\SylixOS\extfs\hoitFs\hoitFsCmd.h", "C++", 0, 6, 20, 3, 29
"d:\MyProject-Temp\Project.HoitOS\HoitOS\SylixOS\Workspace\SylixBSP\SylixOS\extfs\hoitFs\hoitFsFDLib.c", "C", 159, 0, 72, 28, 259
"d:\MyProject-Temp\Project.HoitOS\HoitOS\SylixOS\Workspace\SylixBSP\SylixOS\extfs\hoitFs\hoitFsFDLib.h", "C++", 0, 13, 23, 5, 41
"d:\MyProject-Temp\Project.HoitOS\HoitOS\SylixOS\Workspace\SylixBSP\SylixOS\extfs\hoitFs\hoitFsGC.c", "C", 371, 0, 103, 64, 538
"d:\MyProject-Temp\Project.HoitOS\HoitOS\SylixOS\Workspace\SylixBSP\SylixOS\extfs\hoitFs\hoitFsGC.h", "C++", 0, 39, 31, 13, 83
"d:\MyProject-Temp\Project.HoitOS\HoitOS\SylixOS\Workspace\SylixBSP\SylixOS\extfs\hoitFs\hoitFsLib.c", "C", 1280, 0, 487, 182, 1949
"d:\MyProject-Temp\Project.HoitOS\HoitOS\SylixOS\Workspace\SylixBSP\SylixOS\extfs\hoitFs\hoitFsLib.h", "C++", 0, 61, 26, 14, 101
"d:\MyProject-Temp\Project.HoitOS\HoitOS\SylixOS\Workspace\SylixBSP\SylixOS\extfs\hoitFs\hoitFsLog.c", "C", 359, 0, 127, 82, 568
"d:\MyProject-Temp\Project.HoitOS\HoitOS\SylixOS\Workspace\SylixBSP\SylixOS\extfs\hoitFs\hoitFsLog.h", "C++", 0, 12, 23, 8, 43
"d:\MyProject-Temp\Project.HoitOS\HoitOS\SylixOS\Workspace\SylixBSP\SylixOS\extfs\hoitFs\hoitFsMid.c", "C", 3, 0, 20, 6, 29
"d:\MyProject-Temp\Project.HoitOS\HoitOS\SylixOS\Workspace\SylixBSP\SylixOS\extfs\hoitFs\hoitFsMid.h", "C++", 0, 3, 20, 5, 28
"d:\MyProject-Temp\Project.HoitOS\HoitOS\SylixOS\Workspace\SylixBSP\SylixOS\extfs\hoitFs\hoitFsTest.c", "C", 700, 0, 156, 84, 940
"d:\MyProject-Temp\Project.HoitOS\HoitOS\SylixOS\Workspace\SylixBSP\SylixOS\extfs\hoitFs\hoitFsTest.h", "C++", 0, 5, 20, 2, 27
"d:\MyProject-Temp\Project.HoitOS\HoitOS\SylixOS\Workspace\SylixBSP\SylixOS\extfs\hoitFs\hoitFsTree.c", "C", 452, 0, 233, 81, 766
"d:\MyProject-Temp\Project.HoitOS\HoitOS\SylixOS\Workspace\SylixBSP\SylixOS\extfs\hoitFs\hoitFsTree.h", "C++", 0, 108, 54, 27, 189
"d:\MyProject-Temp\Project.HoitOS\HoitOS\SylixOS\Workspace\SylixBSP\SylixOS\extfs\hoitFs\hoitFsTreeUtil.c", "C", 337, 0, 183, 56, 576
"d:\MyProject-Temp\Project.HoitOS\HoitOS\SylixOS\Workspace\SylixBSP\SylixOS\extfs\hoitFs\hoitFsTreeUtil.h", "C++", 0, 20, 20, 10, 50
"d:\MyProject-Temp\Project.HoitOS\HoitOS\SylixOS\Workspace\SylixBSP\SylixOS\extfs\hoitFs\hoitType.h", "C++", 0, 290, 111, 69, 470
"d:\MyProject-Temp\Project.HoitOS\HoitOS\SylixOS\Workspace\SylixBSP\SylixOS\extfs\spifFs\spifFs.c", "C", 1, 0, 20, 2, 23
"d:\MyProject-Temp\Project.HoitOS\HoitOS\SylixOS\Workspace\SylixBSP\SylixOS\extfs\spifFs\spifFs.h", "C++", 0, 4, 20, 4, 28
"d:\MyProject-Temp\Project.HoitOS\HoitOS\SylixOS\Workspace\SylixBSP\SylixOS\extfs\spifFs\spifFsCache.c", "C", 293, 0, 137, 34, 464
"d:\MyProject-Temp\Project.HoitOS\HoitOS\SylixOS\Workspace\SylixBSP\SylixOS\extfs\spifFs\spifFsCache.h", "C++", 0, 25, 32, 8, 65
"d:\MyProject-Temp\Project.HoitOS\HoitOS\SylixOS\Workspace\SylixBSP\SylixOS\extfs\spifFs\spifFsConfig.h", "C++", 0, 103, 123, 11, 237
"d:\MyProject-Temp\Project.HoitOS\HoitOS\SylixOS\Workspace\SylixBSP\SylixOS\extfs\spifFs\spifFsFDLib.c", "C", 96, 0, 51, 8, 155
"d:\MyProject-Temp\Project.HoitOS\HoitOS\SylixOS\Workspace\SylixBSP\SylixOS\extfs\spifFs\spifFsFDLib.h", "C++", 0, 8, 20, 3, 31
"d:\MyProject-Temp\Project.HoitOS\HoitOS\SylixOS\Workspace\SylixBSP\SylixOS\extfs\spifFs\spifFsGC.c", "C", 423, 0, 165, 44, 632
"d:\MyProject-Temp\Project.HoitOS\HoitOS\SylixOS\Workspace\SylixBSP\SylixOS\extfs\spifFs\spifFsGC.h", "C++", 0, 23, 20, 4, 47
"d:\MyProject-Temp\Project.HoitOS\HoitOS\SylixOS\Workspace\SylixBSP\SylixOS\extfs\spifFs\spifFsGlue.c", "C", 141, 0, 86, 16, 243
"d:\MyProject-Temp\Project.HoitOS\HoitOS\SylixOS\Workspace\SylixBSP\SylixOS\extfs\spifFs\spifFsGlue.h", "C++", 0, 12, 23, 5, 40
"d:\MyProject-Temp\Project.HoitOS\HoitOS\SylixOS\Workspace\SylixBSP\SylixOS\extfs\spifFs\spifFsLib.c", "C", 407, 0, 125, 33, 565
"d:\MyProject-Temp\Project.HoitOS\HoitOS\SylixOS\Workspace\SylixBSP\SylixOS\extfs\spifFs\spifFsLib.h", "C++", 0, 30, 40, 8, 78
"d:\MyProject-Temp\Project.HoitOS\HoitOS\SylixOS\Workspace\SylixBSP\SylixOS\extfs\spifFs\spifFsType.h", "C++", 0, 316, 200, 38, 554
"d:\MyProject-Temp\Project.HoitOS\HoitOS\SylixOS\Workspace\SylixBSP\SylixOS\extfs\spifFs\spifFsVerify.c", "C", 0, 0, 20, 4, 24
"d:\MyProject-Temp\Project.HoitOS\HoitOS\SylixOS\Workspace\SylixBSP\SylixOS\extfs\tools\list\common.h", "C++", 0, 47, 20, 13, 80
"d:\MyProject-Temp\Project.HoitOS\HoitOS\SylixOS\Workspace\SylixBSP\SylixOS\extfs\tools\list\iter.c", "C", 28, 0, 20, 10, 58
"d:\MyProject-Temp\Project.HoitOS\HoitOS\SylixOS\Workspace\SylixBSP\SylixOS\extfs\tools\list\list.c", "C", 96, 0, 20, 20, 136
"d:\MyProject-Temp\Project.HoitOS\HoitOS\SylixOS\Workspace\SylixBSP\SylixOS\extfs\tools\list\list_interface.h", "C++", 0, 36, 26, 4, 66
"d:\MyProject-Temp\Project.HoitOS\HoitOS\SylixOS\Workspace\SylixBSP\SylixOS\extfs\tools\list\list_template.h", "C++", 0, 136, 28, 8, 172
"d:\MyProject-Temp\Project.HoitOS\HoitOS\SylixOS\Workspace\SylixBSP\SylixOS\extfs\tools\list\list_test.c", "C", 78, 0, 25, 13, 116
"Total", "-", 6850, 1399, 3624, 1387, 13260